##################################
#                                #
########################## ### # #
#             #          # # # # #
# # ########### ######## # # # # #
# # #         #        # # # # # #
# # # ##### ########## # #   # # #
# # # # A##   ######## # # # # # #
# #   #       ######## # # # # # #
# # ################## # # # # # #
# #        #           #   # # # #
# ########## ################# ###
#            #S                  #
##################################