#########################################
#S#        #                       #    #
# ##### ####  ############## ####### ## #
#             #                      #A #
#########################################