########################
#A#              #     #
# # # ########## # ### #
# # # #          # # # #
# # # ### ######## # # #
# # # # #    #S    # # #
# ### # #### ####### # #
#     #                #
########################