##########################
#             # #        #
# ######### # # # #####  #
# # # # # # # # #  #  #  #
# # # # # ###   #  # #   #
# #         # #A#### #   #
# # # # # # # #          #
# # # # # # # # ###### # #
# # # # # # # # #   #  # #
# # #######   # # # #### #
# #S#     # # # # #      #
##########################