#########################################
# # # # # # # #S# # # # # # # #   # # # #
# # # # # # # # # # # # # # # # # # # # #
# # # # # # # # # # # #   # # # # # # # #
# #   # # #   # # # # # # # # # # # # # #
# # # # # # # #   # # # # #     # # #   #
# # # # # # # # # # # #   # # # #   # # #
# # #   #   #   #   # # # # # # # # # # #
#   # # # # # # # # #   # # # # # # # # #
# # # # # # # # # # # # #   # # # #   # #
# # # # # #   #   #   # # # # # # # # # #
# # # #   # # # # # # # # # # # # # # #A#
#########################################