###########################
#A#        #              #  
#   ###### #  ########### #
######     #            # #
#      #####  ######## #  #
# ######      #        # ##
#         ######## ##### ##
############        #######
####         ##############
##   #########       #    #
## ###   ##    ####  # ## #
##  #######  ###    ## #S #
##           #          # #
###########################